0	1	2	3	2	2	2	2	2	2	2	2	2	2	2	2	2	2	2
4	5	6	7	2	2	2	2	2	2	2	2	2	2	2	2	2	2	2
8	9	10	11	2	2	2	2	2	2	2	2	2	2	2	2	2	2	2
11 	11	11	11	11	11	11	11	11	11	11	11	11	11	11	11	11	11	11
11 	11	11	11	11	11	11	11	11	11	11	11	11	11	11	11	11	11	11
11 	11	11	11	11	11	11	11	11	11	11	11	11	11	11	11	11	11	11
11 	11	11	11	11	11	11	11	11	11	11	11	11	11	11	11	11	11	11
11 	11	11	11	11	11	11	11	11	11	11	11	11	11	11	11	11	11	11
0      0 	0	0	1	1	1	1	1	1	1	1	1	1	1	1	1	1	1
