0	1	2	3	2	2	2	2	2	2	2	2	2	2	2	2	2	2	2
4	5	6	7	2	2	2	2	2	2	2	2	2	2	2	2	2	2	2
8	9	10	11	2	2	2	2	2	2	2	2	2	2	2	2	2	2	2
2	2	2	2	2	2	2	2	2	2	2	2	2	2	2	2	2	2	2
2	2	2	2	2	2	2	2	2	2	2	2	2	2	2	2	2	2	2
2	2	2	2	2	2	2	2	2	2	2	2	2	2	2	2	2	2	2
28      29 	30	31	1	1	1	1	1	1	1	1	1	1	1	1	1	1	1
