11 	11	11	11	11	11	11	11	11	11	11	11	11	11	11	11	11	11	11
11 	11	11	11	11	11	11	11	11	11	11	11	11	11	11	11	11	11	11
11 	11	11	11	11	11	11	11	11	11	11	11	11	11	11	11	11	11	11
11 	11	11	11	11	11	11	11	11	11	11	11	11	11	11	11	11	11	11
11 	11	11	11	0	1	1	1	1	11	11	11	11	11	11	11	11	11	11
11 	11	11	11	11	11	11	11	11	11	11	11	11	11	11	11	11	11	11
11 	11	11	11	11	11	11	11	11	11	20	11	11	11	20	11	11	11	11
11 	11	11	11	11	11	11	11	11	11	11	11	11	11	11	11	11	11	11
0       1	1	1	1	1	1	1	1	1	1	1	1	1	1	1	1	1	1
