0 1 2 3 4 5 6 7 0 0 0 0 0 0 0 0
8 9 10 11 12 13 14 15 0 0 0 0 0 0 0 0
16 17 18 19 20 21 22 23 0 0 0 0 0 0 0 0 
24 25 26 27 28 29 30 31 0 0 0 0 0 0 0 0
0 0 0 0 0 0 0 0 0 0 0 0 0 0 0 0	
0 0 0 0 0 0 0 0 0 0 0 0 0 0 0 0	
0 0 0 0 0 0 0 0 0 0 0 0 0 0 0 0	
0 0 0 0 0 0 0 0 0 0 0 0 0 0 0 0	
0 0 0 0 0 0 0 0 0 0 0 0 0 0 0 0